11111111111111111111
10000111C10000011111
11000010010000111101
100C00P00000C00000C1
1001001E10C011011101
110000011C0111011111
11111111111111111111